........................................................................................................................
........................................................................................................................
........................................................................................................................
........................................................................................................................
.......CCC...................................................CCC........................................................
......CCCCC.................................................CCCCC.......................................................
.......CCC...................................................CCC........................................................
........................................................................................................................
........................................................................................................................
..........................................+.o.o..................................................................>......
..........................................BBBBBB................................................................>>......
...............................................................................................................>>>......
..............................................................................................................>>>>......
.........................................................o...................................................>>>>>......
.......................................................BBBBB................................................>>>>>>......
.................................................................................................................|......
.....................................................o.o.o.o.....................................................|......
S...................o.o............................BBBBBBBBBBB...................................................|.....S
SS.................BBBBB.........................................................................................|....SS
SSS..............................................................................................................|...SSS
SSSS..........................................B..........o.o.o........BB.........................................|..SSSS
SSSSS..............................GGGG......BBB........BBBBBBB......BBBB........................................|.SSSSS
SSSSSS..............................GG......BBBBB...................BBBBBB............o.o.......................SSSSSSSS
CC...........................GGGG...GG.....BBBBBBB.........E.......BBBBBBBB..........BBBBBB.....................||......
CC.....................GGG....GG....GG....BBBBBBBBB...............BBBBBBBBBB....................................||......
CC..M...................G..o..GG..o.GG...BBBBBBBBBBB.............BBBBBBBBBBBB...................................||......
GGGGGGGGGGGGGGGGGGGGGGGGGGGGGGGGGGGGGGGGGGGGGGGGGGGGGGGGGGGGGGGGGGGGGGGGGGGGGGGGGGGGGGGGGGGGGGGGGGGGGGGGGGGGGGGGGGGGGGGG
SSSSSSSSSSSSSSSSSSSSSSSSSSSSSSSSSSSSSSSSSSSSSSSSSSSSSSSSSSSSSSSSSSSSSSSSSSSSSSSSSSSSSSSSSSSSSSSSSSSSSSSSSSSSSSSSSSSSSSSS
SSSSSSSSSSSSSSSSSSSSSSSSSSSSSSSSSSSSSSSSSSSSSSSSSSSSSSSSSSSSSSSSSSSSSSSSSSSSSSSSSSSSSSSSSSSSSSSSSSSSSSSSSSSSSSSSSSSSSSSS