........................................................................................................................
........................................................................................................................
...........CCC..........................................................................................................
..........CCCCC.....................................CCC.................................................................
...........CCC.....................................CCCCC.................................................CCC............
....................................................CCC.................................................CCCCC...........
.........................................................................................................CCC............
........................................................................................................................
........................................................................................................................
............................................................o.o.........................................................
..................................+..o.o.o.o.o.o...........BBBBB.............o.o........................................
.................................BBBBBBBBBBBBBBBB............................BBBBB......................................
........................................................................................................................
..........................................................o.o...........................................................
...................o.o..................................BBBBBB.........BB...............................................
..................BBBBB...............................................BBBB..............................................
.....................................................................BBBBBB.............................................
....................................................................BBBBBBBB............................................
S..................................................................BBBBBBBBBB..........................................S
SS....................................................................................................................SS
SSS...........................................................o...................................o..................SSS
SSSS.........................................................BBB...............................BBBBB................SSSS
SSSSS....................GGGG......................................................................................SSSSS
SSSSSS............GGGG....GG.......................o.o...................GGGG....................................SSSSSSS
CC.................GG.....GG..............BBBBBBBBBBBBBBBB........GGGG....GG...............BBBBBBBBBBBBB..............CC
CC.................GG.....GG.......................................GG.....GG..........................................CC
CC..M..............GG..o..GG.............o...o...o...o..o..........GG.....GG..........................................CC
GGGGGGGGGGGGGGGGGGGGGGGGGGGGGGGGGGGGGGGGGGGGGGGGGGGGGGGGGGGGGGGGGGGGGGGGGGGGGGGGGGGGGGGGGGGGGGGGGGGGGGGGGGGGGGGGGGGGGGGG
SSSSSSSSSSSSSSSSSSSSSSSSSSSSSSSSSSSSSSSSSSSSSSSSSSSSSSSSSSSSSSSSSSSSSSSSSSSSSSSSSSSSSSSSSSSSSSSSSSSSSSSSSSSSSSSSSSSSSSSS
SSSSSSSSSSSSSSSSSSSSSSSSSSSSSSSSSSSSSSSSSSSSSSSSSSSSSSSSSSSSSSSSSSSSSSSSSSSSSSSSSSSSSSSSSSSSSSSSSSSSSSSSSSSSSSSSSSSSSSSS